ang – angustifolium
arb – arboreum
bor – boreale
ces – cespitosum
con – confertum
cor – corymbosum
cos – consanguineum
cra – crassifolium
crd – cordifolium
dar – darrowii
del – deliciosum
ery – erythrocarpum
gem – geminiflorum
hir – hirsutum
kun – kunthianum
leu – leucanthum
mac – macrocarpon
mem – membranaceum
mtu – myrtillus
myr – myrtilloides
mys – myrsinites
ova – ovalifolium
ovt – ovatum
oxy – oxycoccos
pal – pallidum
par – parvifolium
sco – scoparium
sel – selerianum
sha – shastense
sta – stamineum
ste – stenophyllum
ten – tenellum
uli – uliginosum
vid – vitis-idaea
